NO ./textures/test1.xpm
SO ./textures/test2.xpm
WE ./textures/test3.xpm
EA ./textures/test4.xpm
F             220,100,0
C 225,30,0

11111111111111111111111111111111111111111111111
1111111111111111111111111111111111111111111111111
100000011111110000010000000000101000100000000000011111111111111111
10000001111111000000000001000000000000000000000001
10000000000000000011000000000100000000001100000001
10000000000000001100111000001010000000001100000001
10000100000000110000000110000100000000001100000001
10000110000011000000000001000000000000001100000001   111111111111111111
10000101000010000000000000100000000000001100000001   100000000000000001
10000101000100000000011000100000000000001100000001   100000000000000001
10000100100100000000011000010000000000001100000001   100000000000000001
10000100111000000000000000001000000000000000000001   100000000000000001
10000100000000000000100000001000000000000000000001   100000000000000001
10000100111000000000100000001000000000000000000001   100000000000000001
10000100100100000000010000001000000000000000000001   111111111111111111
10000101000100000000001000010000000000000000000001
10000101000010000000000111100000000000000000000001
1000011000001100000000000100000000000000000000000111111111111111111111111111111111111111111111111
1000010000000011000000001100000000000000000000000000000000000000000000000000000000000000000000001
1111111111111111111000011111111111111111111111111111111111111111111111111111111111111111111111111
10000000000000000000000000000000000000000000000000000000000000001
1000000000000000001100000000000000000000000000000111111111111111111111111111111111111111111111111
10000000000000000000000000000000000000000000000001
10000000000000000000000000011111111111111111111111
100000000000000000000000001
100111111111111111111111111
1001
10011111111111111111111111111111111111111111111111111
10000000000000000000000000000000000000000000000001
10000000000001111000000000000000000000000000000001
10000000000001  1000000000000000000000000000000001
10000000000001  1000000000000000000000000000000001
10000000000001  1000000000000000000000000000000001
10000000000001  1000000000000000000000000000000001
10000000000001111000000000000000000000000000000001
10000000000000000000000000000000000000000000000001
10000000000000000000000000000000000000000000000001
10000000000000000000000000000000000000000000000001
1000000000000000000000001111000000000N000000000001
111111111111111111111111    1111111111111111111111   
11111111111111111111111111111111111111111111111
1111111111111111111111111111111111111111111111111
100000011111110000010000000000101000100000000000011111111111111111
10000001111111000000000001000000000000000000000001
10000000000000000011000000000100000000001100000001
10000000000000001100111000001010000000001100000001
10000100000000110000000110000100000000001100000001
10000110000011000000000001000000000000001100000001   111111111111111111
10000101000010000000000000100000000000001100000001   100000000000000001
10000101000100000000011000100000000000001100000001   100000000000000001
10000100100100000000011000010000000000001100000001   100000000000000001
10000100111000000000000000001000000000000000000001   100000000000000001
10000100000000000000100000001000000000000000000001   100000000000000001
10000100111000000000100000001000000000000000000001   100000000000000001
10000100100100000000010000001000000000000000000001   111111111111111111
10000101000100000000001000010000000000000000000001
10000101000010000000000111100000000000000000000001
1000011000001100000000000100000000000000000000000111111111111111111111111111111111111111111111111
1000010000000011000000001100000000000000000000000000000000000000000000000000000000000000000000001
1111111111111111111000011111111111111111111111111111111111111111111111111111111111111111111111111
10000000000000000000000000000000000000000000000000000000000000001
1000000000000000001100000000000000000000000000000111111111111111111111111111111111111111111111111
10000000000000000000000000000000000000000000000001
10000000000000000000000000011111111111111111111111
100000000000000000000000001
100111111111111111111111111
1001
10011111111111111111111111111111111111111111111111111
10000000000000000000000000000000000000000000000001
10000000000001111000000000000000000000000000000001
10000000000001  1000000000000000000000000000000001
10000000000001  1000000000000000000000000000000001
10000000000001  1000000000000000000000000000000001
10000000000001  1000000000000000000000000000000001
10000000000001111000000000000000000000000000000001
10000000000000000000000000000000000000000000000001
10000000000000000000000000000000000000000000000001
10000000000000000000000000000000000000000000000001
10000000000000000000000011110000000000000000000001
111111111111111111111111    1111111111111111111111
11111111111111111111111111111111111111111111111
1111111111111111111111111111111111111111111111111
100000011111110000010000000000101000100000000000011111111111111111
10000001111111000000000001000000000000000000000001
10000000000000000011000000000100000000001100000001
10000000000000001100111000001010000000001100000001
10000100000000110000000110000100000000001100000001
10000110000011000000000001000000000000001100000001   111111111111111111
10000101000010000000000000100000000000001100000001   100000000000000001
10000101000100000000011000100000000000001100000001   100000000000000001
10000100100100000000011000010000000000001100000001   100000000000000001
10000100111000000000000000001000000000000000000001   100000000000000001
10000100000000000000100000001000000000000000000001   100000000000000001
10000100111000000000100000001000000000000000000001   100000000000000001
10000100100100000000010000001000000000000000000001   111111111111111111
10000101000100000000001000010000000000000000000001
10000101000010000000000111100000000000000000000001
1000011000001100000000000100000000000000000000000111111111111111111111111111111111111111111111111
1000010000000011000000001100000000000000000000000000000000000000000000000000000000000000000000001
1111111111111111111000011111111111111111111111111111111111111111111111111111111111111111111111111
10000000000000000000000000000000000000000000000000000000000000001
1000000000000000001100000000000000000000000000000111111111111111111111111111111111111111111111111
10000000000000000000000000000000000000000000000001
10000000000000000000000000011111111111111111111111
100000000000000000000000001
100111111111111111111111111
1001
10011111111111111111111111111111111111111111111111111
10000000000000000000000000000000000000000000000001
10000000000001111000000000000000000000000000000001
10000000000001  1000000000000000000000000000000001
10000000000001  1000000000000000000000000000000001
10000000000001  1000000000000000000000000000000001
10000000000001  1000000000000000000000000000000001
10000000000001111000000000000000000000000000000001
10000000000000000000000000000000000000000000000001
10000000000000000000000000000000000000000000000001
10000000000000000000000000000000000000000000000001
10000000000000000000000011110000000000000000000001
111111111111111111111111    1111111111111111111111
11111111111111111111111111111111111111111111111
1111111111111111111111111111111111111111111111111
100000011111110000010000000000101000100000000000011111111111111111
10000001111111000000000001000000000000000000000001
10000000000000000011000000000100000000001100000001
10000000000000001100111000001010000000001100000001
10000100000000110000000110000100000000001100000001
10000110000011000000000001000000000000001100000001   111111111111111111
10000101000010000000000000100000000000001100000001   100000000000000001
10000101000100000000011000100000000000001100000001   100000000000000001
10000100100100000000011000010000000000001100000001   100000000000000001
10000100111000000000000000001000000000000000000001   100000000000000001
10000100000000000000100000001000000000000000000001   100000000000000001
10000100111000000000100000001000000000000000000001   100000000000000001
10000100100100000000010000001000000000000000000001   111111111111111111
10000101000100000000001000010000000000000000000001
10000101000010000000000111100000000000000000000001
1000011000001100000000000100000000000000000000000111111111111111111111111111111111111111111111111
1000010000000011000000001100000000000000000000000000000000000000000000000000000000000000000000001
1111111111111111111000011111111111111111111111111111111111111111111111111111111111111111111111111
10000000000000000000000000000000000000000000000000000000000000001
1000000000000000001100000000000000000000000000000111111111111111111111111111111111111111111111111
10000000000000000000000000000000000000000000000001
10000000000000000000000000011111111111111111111111
100000000000000000000000001
100111111111111111111111111
1001
10011111111111111111111111111111111111111111111111111
10000000000000000000000000000000000000000000000001
10000000000001111000000000000000000000000000000001
10000000000001  1000000000000000000000000000000001
10000000000001  1000000000000000000000000000000001
10000000000001  1000000000000000000000000000000001
10000000000001  1000000000000000000000000000000001
10000000000001111000000000000000000000000000000001
10000000000000000000000000000000000000000000000001
10000000000000000000000000000000000000000000000001
10000000000000000000000000000000000000000000000001
10000000000000000000000011110000000000000000000001
111111111111111111111111    1111111111111111111111
11111111111111111111111111111111111111111111111
1111111111111111111111111111111111111111111111111
100000011111110000010000000000101000100000000000011111111111111111
10000001111111000000000001000000000000000000000001
10000000000000000011000000000100000000001100000001
10000000000000001100111000001010000000001100000001
10000100000000110000000110000100000000001100000001
10000110000011000000000001000000000000001100000001   111111111111111111
10000101000010000000000000100000000000001100000001   100000000000000001
10000101000100000000011000100000000000001100000001   100000000000000001
10000100100100000000011000010000000000001100000001   100000000000000001
10000100111000000000000000001000000000000000000001   100000000000000001
10000100000000000000100000001000000000000000000001   100000000000000001
10000100111000000000100000001000000000000000000001   100000000000000001
10000100100100000000010000001000000000000000000001   111111111111111111
10000101000100000000001000010000000000000000000001
10000101000010000000000111100000000000000000000001
1000011000001100000000000100000000000000000000000111111111111111111111111111111111111111111111111
1000010000000011000000001100000000000000000000000000000000000000000000000000000000000000000000001
1111111111111111111000011111111111111111111111111111111111111111111111111111111111111111111111111
10000000000000000000000000000000000000000000000000000000000000001
1000000000000000001100000000000000000000000000000111111111111111111111111111111111111111111111111
10000000000000000000000000000000000000000000000001
10000000000000000000000000011111111111111111111111
100000000000000000000000001
100111111111111111111111111
1001
10011111111111111111111111111111111111111111111111111
10000000000000000000000000000000000000000000000001
10000000000001111000000000000000000000000000000001
10000000000001  1000000000000000000000000000000001
10000000000001  1000000000000000000000000000000001
10000000000001  1000000000000000000000000000000001
10000000000001  1000000000000000000000000000000001
10000000000001111000000000000000000000000000000001
10000000000000000000000000000000000000000000000001
10000000000000000000000000000000000000000000000001
10000000000000000000000000000000000000000000000001
10000000000000000000000011110000000000000000000001
111111111111111111111111    1111111111111111111111
11111111111111111111111111111111111111111111111
1111111111111111111111111111111111111111111111111
100000011111110000010000000000101000100000000000011111111111111111
10000001111111000000000001000000000000000000000001
10000000000000000011000000000100000000001100000001
10000000000000001100111000001010000000001100000001
10000100000000110000000110000100000000001100000001
10000110000011000000000001000000000000001100000001   111111111111111111
10000101000010000000000000100000000000001100000001   100000000000000001
10000101000100000000011000100000000000001100000001   100000000000000001
10000100100100000000011000010000000000001100000001   100000000000000001
10000100111000000000000000001000000000000000000001   100000000000000001
10000100000000000000100000001000000000000000000001   100000000000000001
10000100111000000000100000001000000000000000000001   100000000000000001
10000100100100000000010000001000000000000000000001   111111111111111111
10000101000100000000001000010000000000000000000001
10000101000010000000000111100000000000000000000001
1000011000001100000000000100000000000000000000000111111111111111111111111111111111111111111111111
1000010000000011000000001100000000000000000000000000000000000000000000000000000000000000000000001
1111111111111111111000011111111111111111111111111111111111111111111111111111111111111111111111111
10000000000000000000000000000000000000000000000000000000000000001
1000000000000000001100000000000000000000000000000111111111111111111111111111111111111111111111111
10000000000000000000000000000000000000000000000001
10000000000000000000000000011111111111111111111111
100000000000000000000000001
100111111111111111111111111
1001
10011111111111111111111111111111111111111111111111111
10000000000000000000000000000000000000000000000001
10000000000001111000000000000000000000000000000001
10000000000001  1000000000000000000000000000000001
10000000000001  1000000000000000000000000000000001
10000000000001  1000000000000000000000000000000001
10000000000001  1000000000000000000000000000000001
10000000000001111000000000000000000000000000000001
10000000000000000000000000000000000000000000000001
10000000000000000000000000000000000000000000000001
10000000000000000000000000000000000000000000000001
10000000000000000000000011110000000000000000000001
111111111111111111111111    1111111111111111111111