NO ./textures/test1.png
SO ./textures/test2.png
WE ./textures/test3.png
EA ./textures/test4.png

F 220,100,0
C 150,190,180

 111111111
10000010001
100W0100001
11000001011
10100000101
11000010011
10000100001
10001010001
 111111111