NO ./textures/test1.xpm
SO ./textures/test2.xpm
WE ./textures/test3.xpm
EA ./textures/test4.xpm

F 100,100,50
C 150,190,255

 111111111
1000E010001
10000100001
11010001011
10111000011
11010010011
10000101111
1000100001
 111111111