SO ./textures/test2.png
F 67,33,250
C 225,30,0
NO ./textures/test1.png
WE ./textures/test3.png
EA ./textures/test4.png


1111111111111111111111111111111111111111111111111
1000000000000000000000000000000000000000000000001
1010000000001110010011001000111011001100110000001
1010000000001 100100110010001 1011001100110000001
1010000000001 100100110010001 1011001100110000001
1000000000001 100100110010001 1011001100110000001
11100W0000001 111100110111001 1011001100110000001
1110000000001110000000000000111000000000000000011
1111111111111 111111111111111 11111111111111111
 
111
101
111