NO ./textures/test1.png
SO ./textures/test2.png
WE ./textures/test3.png
EA ./textures/test4.png

F 24,20,37
C 77,45,51

1111111111111  1111111111111
1S00000000001  1000000000001
1000000000001  1000000000001
1000000000001  1000000000001
1111110111111  1111110111111
     101            101
     101            101
     101            101
     101            101
     101111111111111101
     100000000000000001
     111111111111111111