NO ./textures/test1.xpm

SO ./textures/test2.xpm
WE ./textures/test3.xpm
EA ./textures/test4.xpm
F             220,100,0
C 225,30,255


111111111111111111111111111111111111111111111111111111111111
10000000000000000100000000000000000000000000000000000000001
10000000000000000000000000000001000000000000000000000000001
10000000000000000000000000000000000000000100000000000000001
10000W00000000000000000000000000000000000000000000010000001
10000000000000000000000000000000000000000000000000000010001
10000000000000000000000000000000000000000000000000000000001
10000000000000000000000010000000000000000000000000000000001
11111111111111111111111111111111111111111111111111111111111