NO ./textures/test1.xpm
SO ./textures/test2.xpm
WE ./textures/test3.xpm
EA ./textures/test4.xpm

C 0,0,0
F 0,0,0
1111111111111111
1000000000000001
1000000000000001
1000000000000001
1000000000000001111111111111111111111111111
1000000000000000000000000000000000000000001
1000000000000000000000000000000000000000001
1000000000000000000000000000000000000000001
1000000001000000000000000000000000000000001
1000000001000000000000000000000000000000001
1000000000001000000000000000000000000000001
1000000000001000000000000000000000000000001
1000000000001000000000000000000000000000001
1000000000000010000000000000000000000000001
1000000000000010000000000000000000000000001
1000000000000000000000000000000000000000001
1000000000000000000000000000000000000000001
1000000000000000000000000000001000000000001
1000000000000000000W00000000001000000000001
1000000000000000000000000000001000000000001
1000000011000000000000000000000000000000001
1000000010000000000000000000000000000000001
1000000000000000000000000000000000000000001
1000000000000000000000000000000000000000001
1000000000000011111111100000000000000000001
1000000000000000000000000000000000000000001
1000000000000000000000000000000000000000001
1000000000000000000000000000000000000000001
1000011000000000000000000000001000000000001
1000001000000000000000000000001000000000001
1000001110000000000000000000001000000000001
1000000000000000000000000000000000000000001
1000000000000000000000000000000000000000001
1000000000000001111111111111111111111111111
1000000000000000000000000000000000000000001
1000000000000000000000000000000000000000001
1000000000000001111111111111111111111111111
1000000000000001
1000000000000001
1000000000000001
1000000000000001
1000000000000001
1000000000000001
1111111111111111
