NO ./textures/test1.png
SO ./textures/test2.png
WE ./textures/test3.png
F 20,1,0
EA ./textures/test4.png
C 0,0,0

11111111111111111111111111
1100000000000000000000001
1100000000000000000000001
1100000000000000000000001
1100000111110000000000001
1100000100010000000000001
1100000100010000000000001
1100000100010000000000001
1100000111000000000000001
1100000000000000000000001
1100000000010000000000001
1100000000010000000000001
1100000000010000000000001
1100000000010000000000001
1100000000010000000000001
1100000000010000000000001
1100000000010000000000001
1100000000010000000000001
1100000000000000000000001
1100000000000000000000001
1100000000000000000000001
1100000000000000000000001
1100000000000000000011001
1S01111111111111111111111
1111111111111111111111111
