NO ./textures/test1.xpm
SO ./textures/test2.xpm
WE ./textures/test3.xpm
EA ./textures/test4.xpm

F 31,57,30
C 182,144,71

1111111111111
1001000000001
1000011111001
100011N000001
1111111111111