NO ./textures/test1.png
SO ./textures/test2.png
WE ./textures/test3.png
EA ./textures/test4.png

C 151,219,198
F 83,84,96

111111111111111111111111111111111
100000000000000000000000000000001
100000000000000000000000000000001
100011111111111111111111100000001
100010000000000000000000110000001
100010000000000000000000010000001
10001000E000000000000000010000001
100010000000000000000000010000001
100010000000000000000000011110001
100011111111111111111100000010001
100010000000000000010000000010001
100010000000000000010000000010001
100010000000010000010000000010001
100010000000010000010000000010001
100010000000010000000000000010001
100010000000010000000000000010001
100010000111111111111111111110001
100010000000000000000000000010001
100010000000000000000000000010001
100010000000000000000000000010001
100011111111111111110000000010001
100010000000010000000000000010001
100010000000010000000000000010001
100010000000000000000000000010001
100011100111011111111111111110001
100000000000000000000000000000001
100000000000000000000000000000001
111111111111111111111111111111111
