NO ./textures/test1.xpm
SO ./textures/test2.xpm
WE ./textures/test3.xpm
EA ./textures/test4.xpm

F 24,20,37
C 77,45,51

1111111111111111111111111111111111
1000000000000000000000000000000001
1010010100100000101001000000010101
1110010010101010001001000000010101
1E00000000000000000000000000000001
1111111111111111111111111111111111
