NO ./textures/test1.png
SO ./textures/test2.png
WE ./textures/test3.png
EA ./textures/test4.png
F 64,64,64 
C 112,163,204

111111111111
100000000001
100000000001
100001100001
100001100001
100N00000001
100000000001
111111111111
