NO ./textures/test1.png
SO ./textures/test2.png
WE ./textures/test3.png
EA ./textures/test4.png

F 24,20,37
C 77,45,51

1111111111111
10000000000W1
1111111111111