C 155,96,4
F 200,200,200

NO ./textures/test1.png
SO ./textures/test2.png
WE ./textures/test3.png
EA ./textures/test4.png

1111
1E01
1111
