NO ./textures/test1.png
SO ./textures/test2.png
WE ./textures/test3.png
EA ./textures/test4.png

F 1769,11,105
C 105,176,11

1111111111111111
1000000000000001
1111100100011001
1000000100001001
1001100100001001
1000100100000001
1011100000000001
1010001100111101
1010111000000101
1000001001100101
1000001000100001
1000000N00101111
1000100011100001
1000100000001101
1000100000000001
1111111111111111
