NO ./textures/test1.png
SO ./textures/test2.png
WE ./textures/test3.png
EA ./textures/test4.png

F 220,100,0
C 90,30,255

111111111111111111111111
100001000001000001000001
101101011101011101011101
1001000100N0010000010001
110111010111010111010101
100000000000000000000001
111111111111111111111111
