NO ./textures/goldeneye-no.xpm
SO ./textures/goldeneye-so.xpm
WE ./textures/goldeneye-we.xpm
EA ./textures/goldeneye-ea.xpm

F 124,124,124
C 49,49,67

1111111111111111
1000000000000001111
10001110000001000001
100N0011110001011101
1000001000100101 101111111111111
1000001000000101 100000000000001
1111111100111101 101111110011111
1000000000100001 1011111001
1010101000001111 101111001
1010101011111   110111001
1010101000001  101011001
1010101111101  10000001
1010101000001  1000111
1010101011111  10001
1010101000001  10001
10111011111011110101
10000010000000000001
1111111111111111111 
