NO ./textures/lego-n.xpm
SO ./textures/lego-s.xpm
WE ./textures/lego-w.xpm
EA ./textures/lego-e.xpm

F 40,127,70
C 0,166,244

11111111111111
10000000000001
10000010000001
100N0011110001
10000010000001
10000000000001
11111111111111
