NO ./textures/test1.png
SO ./textures/test2.png
WE ./textures/test3.png
EA ./textures/test4.png

F 80,80,80
C 120,120,200

111111111111111111111111
100001000001000001000001
101101011101011101011101
100100010000W10000010001
110111010111010111010101
100000000000000000000001
111111111111111111111111
