NO ./textures/test1.xpm                  
SO                       ./textures/test2.xpm
WE ./textures/test3.xpm
EA           ./textures/test4.xpm

C                       12,12,12
F 12,12,12                      


111111
100101
001001
1100N1
111111




