NO ./textures/test1.xpm
SO ./textures/test2.xpm
WE ./textures/test3.xpm
EA ./textures/test4.xpm

F 220,100,0
C 225,30,255

1111111111110
1001000000001
1000011111001
100011E000001
1111111111111