NO ./textures/test1.xpm                  
SO                       ./textures/test2.xpm
WE ./textures/test3.xpm
EA           ./textures/test4.xpm

F 12,12,12
C 34,12,12

1111
 000111
 00N001
 0001
1111

