NO ./textures/test1.xpm
SO ./textures/test2.xpm
WE ./textures/test3.xpm
EA ./textures/test4.xpm

F 176,11,105
C 105,176,11

1111111111111111
1000000000000001
1000000000000001
1000000000000001
1000000000000001
1000000000000001
1111111111111111

1111111111111111
1000000000000001
1000000000000001
10000000E0000001
1000000000000001
1000000000000001
1000000000000001
1000000000000001
1000000000000001
1000000000000001
1111111110111111






