NO ./textures/test1.png
SO ./textures/test2.png
WE ./textures/test3.png
EA ./textures/test4.png

F 220,100,0
C 225,30,255

1111101111111
1001000000001
1000011111001
100011E000001
1111111111111